1111111111111111111111
1C10001011101110101111
101C101111111111111011
1001000P000000000C1111
1011101011011010111C11
1C111110101010100C1011
1000111011011010111011
1010101010010110101011
1110111010001C10111011
1000C00C101010000C00E1
1111111111111111111111