1111111111111111111
1010000000C110000E1
1001000000010000001
1000000000C00001001
10000C0C010C0000001
10000C010C010000001
1000010C0C0C0000001
10000C010C0C0000001
10000C0C0P0C0000011
10000C010C0C0000001
10000C0C0C0C0000011
1111111111111111111