1111111111111111111111111111111111
1010000E000000C00100C0000000000001
1P10010100100000101001000000010101
1010010010101010001001000000010101
100011110C00C000000000C000000001C1
1111C00011110011000011100000000101
100000001000000C11111C000001110001
1111111111111111111111111111111111