111111111111111111
11111111E00C111111
11111111CPC0000111
111111111111111111