1111111111111111111111111111111111111111
1E0PC000000000000000000000000000000111C1
10000000C0000000000C000000C0000000000101
1001000100100010001110001000100111110001
10001010001000100100010010C01001C0000001
10000100C0100010C01100001000100111110001
100001000010C0100001100010C0100100000001
10000100C01000100100C1001000100100000001
100001000001110C0011100001110001000C0001
101000000000000000000000000C000000000001
10110000000000C0000000000000000000C00001
1111111111111111111111111111111111111111