1111111111111111111111111111111111111111111
1C10000010111001110011110000111001110101111
101C100011111111111111111110011111111111011
100100000P0000000000001000000000000000C1111
1011101010010110100000000100000000000111C11
1C11111010100010100C10000000000001000000011
1000111011011010001100000010000000000001011
1010101010010001101010000000001000000000011
1C111110101010100C1000000001000110000000011
1000111011011010110000000000111000000001011
1010101010010110101000000000100001100000011
1C111110101010100C1000000000110000100000011
1000111011011010110000000011000000010001011
1010101010010110101000000000000000001110011
11101110110001C1011100000010010000000101011
1000C00C101010000C0011110000000000000011E11
1000111011011010110000110000000000001011111
1010101010010110101000110000000100000011111
1110111010001C10111001110000000100000011111
1000C00C101010000C0000000000010000000001111
1110111010001C10111000000000100000000000111
1000C00C101010000C0000000000100000000000011
1000C00C101010000C0000000001000000000000101
1111101111111110000111110110111111111110111
1000C00C101010000C0000000001000000000000101
1111111111111111111111111111111111111111111